]###############
],,,,I#,#,,,,#I#
]#,####,,,##,#,#
]I,,,,,,#,,#,,,#
]###,~~~~~,#####
]#I#,~~~~~,,,,,#
],,#,~~~~~,###,#
],##,###~~,,,#,#
],,,,#I#,###I#,#
DR,,##,#,,,###,#
],,,,,,#I#,,,,,#
]###############
